XXXXXXXXXXXXXXXXXXXXXXXXXXX
XWWWWWWWWWWWWWWWWWWWWWWWWWX
XWFFFWWFFWFFCWFFFFFFFFFFFWX
XWFWFFFFWWFWFWFWWWWWWWFWFWX
XWFWFWWFWWWWFWFWFWWWWWFWFWX
XWFWWWFFFFFFFFFFFFFFFFFWWWX
XWFWWWWWWFWWFFWFWFWFWWFWFWX
XWFFFFFFFFWWWWFFFFWFWWFFFWX
XWWWWWWFWFWWWWWWWWWFWWWWWWX
XWXXXXWFWFFFFFFFFFWFWXXXXWX
XWXXXXWFWFWWWGWWWFWFWXXXXWX
XWWWWWWFWFW0XUX1WFWFWWWWWWX
XWFFFFFFFFWXXUXXWFFFFFFFFWX
XWWWWWWFWFWXX2XXWFWFWWWWWWX
XWXXXXWFWFWWWWWWWFWFWXXXXWX
XWXXXXWFWFWFWPWFWFWFWXXXXWX
XWWWWWWFFFWFFFWFFFWFWWWWWWX
XWFFFFFFWFFFFWFFFFWFFFFFFWX
XWFWWWWFWFWWWWWWWFWFWWWWFWX
XWFFFWWWWWWFFFFFFFFFFFFFFWX
XWFWWWWFFFWWWWWFFFWWWWWWFWX
XWFWWWWFWWFWFWFWFWWWWWWWFWX
XWFFFFWWWWWFFWFFFFFFFFFFFWX
XWWWWWWWWWWWWWWWWWWWWWWWWWX
XXXXXXXXXXXXXXXXXXXXXXXXXXX