XXXXXXXXXXXXXXXXXXXXXXXXXXX
XWWWWWWWWWWWWWWWWWWWWWWWWWX
XWFFFWWFFWFFFWFFFFFFFFFFFWX
XWFWFWWFWWFWFWFWWWWFWWFWFWX
XWFWFWWFWWWWFWFWFWWFWFWWFWX
XWFFFFFFFFFFFFFFFFFFFFFFFWX
XWFWWWWFWFWWFFWFWFWFWWWWFWX
XWFFFCFFWFFFFWFFFFWFFFFFFWX
XWWWWWWFWWWWFWFWWWWFWWWWWWX
XWXXXXWFWFFFFFFFFFWFWXXXXWX
XWXXXXWFWFWWWGWWWFWFWXXXXWX
XWWWWWWFWFW0XUX1WFWFWWWWWWX
XWFFFFFFFFWXXUXXWFFFFFFFFWX
XWWWWWWFWFWXX2XXWFWFWWWWWWX
XWXXXXWFWFWWWWWWWFWFWXXXXWX
XWXXXXWFWFFFFPFFFFWFWXXXXWX
XWWWWWWFWWWWFWFWWWWFWWWWWWX
XWFFFFFFWFFFFWFFFFWFFFFFFWX
XWFWWWWFWFWWWWWWWFWFWWWWFWX
XWFFFWWWWWWFFFFFFFFFFFFFFWX
XWFWWWWFWWWWFWFWFWWFWWWWFWX
XWFWWWWFWWFWFWFWFWWFWWWWFWX
XWFFFFFFFFFFFWFFFFFFFFFCFWX
XWWWWWWWWWWWWWWWWWWWWWWWWWX
XXXXXXXXXXXXXXXXXXXXXXXXXXX