XXXXXXXXXXXXXXXXXXXXXXXXXXX
XWWWWWWWWWWWWWWWWWWWWWWWWWX
XWFFFFFFFFFFFWFFFFFFFFFFFWX
XWFWFWWFWWWWFWFWWWWFWWWWFWX
XWFWFWWFWWWWFWFWWWWFWWWWFWX
XWFFFFFFFFFFFFFFFFFFFFFFFWX
XWFWWWWFWFWWWWWWWFWFWWWWFWX
XWFFFCFFWFFFFWFFFFWFFFFFFWX
XWWWWWWFWWWWFWFWWWWFWWWWWWX
XWXXXXWFWFFFFFFFFFWFWXXXXWX
XWXXXXWFWFWWWGWWWFWFWXXXXWX
XWWWWWWFWFW0XUX1WFWFWWWWWWX
XDFFFFFFFFWXXUXXWFFFFFFFFDX
XWWWWWWFWFWXX2XXWFWFWWWWWWX
XWXXXXWFWFWWWWWWWFWFWXXXXWX
XWXXXXWFWFFFFPFFFFWFWXXXXWX
XWWWWWWFWWWWFWFWWWWFWWWWWWX
XWFFFFFFWFFFFWFFFFWFFFFFFWX
XWFWWWWFWFWWWWWWWFWFWWWWFWX
XWFFFFFFFFFFFFFFFFFFFFFFFWX
XWFWWWWFWWWWFWFWWWWFWWWWFWX
XWFWWWWFWWWWFWFWWWWFWWWWFWX
XWFFFFFFCFFFFWFFFFFFFFFFFWX
XWWWWWWWWWWWWWWWWWWWWWWWWWX
XXXXXXXXXXXXXXXXXXXXXXXXXXX